111111111111111111111
1000000000000C00000E1
100P000111000C00M0001
100000001000000011001
100C00M01000000011001
10000000000C000000001
111111111111111111111
