11111111111111111111111111111111111
100000000000000000000000000000E0001
10000000C00000000000000000000000111
100000111111111100000000010000001C1
10000011111111110000000000000001101
10000000000100000000000000000000101
10000000000100000000000000000000101
10000000000100000001111111111000101
10000000000100000000000000000000101
10000000000100000000000000000000101
10000000000100000000000000000000001
10000000000100111110001000000000001
100000000001001M0000001000000000001
10000000000000100000001000000000001
100000000000P01C0000001000000000001
10000000000000111111111000000000001
10000000000000100000000000000000001
11111111111111111111111111111111111
