11111111111111111111111111111
100000000000000000000000E0001
10000000C00000000000000000111
100000111111111100010000001C1
10000011110000000000000001101
10000000000100000111111000101
10000100111110001000000000001
100001001M0000001000000000001
10000000100000001000000000001
100000P01C0000001000000000001
10000000111111111000000000001
11111111111111111111111111111
